/other/health/malady	other/health/malady
/organization/company	organization/company
/other/award	other/award
/person/legal	person/legal
/location	location
/location/geograpy/island	location/geograpy/island
/other/art/broadcast	other/art/broadcast
/person/religious_leader	person/religious/leader
/location/structure/hospital	location/structure/hospital
/location/transit	location/transit
/person/military	person/military
/person/artist/actor	person/artist/actor
/person/coach	person/coach
/other/language	other/language
/person/artist/director	person/artist/director
/location/country	location/country
/organization/company/news	organization/company/news
/other/product/computer	other/product/computer
/other/product/software	other/product/software
/organization	organization
/person/doctor	person/doctor
/other/art/film	other/art/film
/organization/political_party	organization/political/party
/other/art	other/art
/other/supernatural	other/supernatural
/other/language/programming_language	other/language/programming/language
/location/structure/government	location/structure/government
/other	other
/other/living_thing/animal	other/living/animal
/organization/education	organization/education
/other/art/stage	other/art/stage
/other/event/election	other/event/election
/other/health/treatment	other/health/treatment
/location/structure/theater	location/structure/theater
/organization/sports_league	organization/sports/league
/other/food	other/food
/location/city	location/city
/organization/sports_team	organization/sports/team
/location/structure/sports_facility	location/structure/sports/facility
/other/art/writing	other/art/writing
/location/structure/airport	location/structure/airport
/organization/company/broadcast	organization/company/broadcast
/other/internet	other/internet
/other/art/music	other/art/music
/location/geography/island	location/geography/island
/other/scientific	other/scientific
/organization/stock_exchange	organization/stock/exchange
/other/product/weapon	other/product/weapon
/person/title	person/title
/organization/government	organization/government
/organization/music	organization/music
/organization/military	organization/military
/other/heritage	other/heritage
/other/product	other/product
/person/political_figure	person/political/figure
/other/legal	other/legal
/other/living_thing	other/living
/location/celestial	location/celestial
/location/geography	location/geography
/location/transit/bridge	location/transit/bridge
/person	person
/other/event/protest	other/event/protest
/person/artist/author	person/artist/author
/other/health	other/health
/location/structure	location/structure
/other/currency	other/currency
/other/event/violent_conflict	other/event/violent/conflict
/other/event/natural_disaster	other/event/natural/disaster
/location/transit/road	location/transit/road
/person/artist/music	person/artist/music
/location/transit/railway	location/transit/railway
/other/event/holiday	other/event/holiday
/location/structure/hotel	location/structure/hotel
/other/religion	other/religion
/person/athlete	person/athlete
/person/artist	person/artist
/location/park	location/park
/location/geography/body_of_water	location/geography/body/water
/other/event	other/event
/other/sports_and_leisure	other/sports/leisure
/other/event/sports_event	other/event/sports/event
/other/product/car	other/product/car
/location/geography/mountain	location/geography/mountain
/organization/transit	organization/transit
/other/body_part	other/body/part
/other/product/mobile_phone	other/product/mobile/phone