/PRODUCT/WEAPON	weapon
/GPE/STATE_PROVINCE	state/province
/FACILITY	facility
/ORGANIZATION/POLITICAL	political
/WORK_OF_ART/SONG	song
/PRODUCT	product
/FACILITY/BUILDING	building
/LOCATION/LAKE_SEA_OCEAN	lake/sea/ocean
/SUBSTANCE/CHEMICAL	chemical
/EVENT	event
/WORK_OF_ART	work/art
/SUBSTANCE/DRUG	drug
/GPE/CITY	city
/LOCATION/RIVER	river
/ORGANIZATION/HOTEL	hotel
/ORGANIZATION/CORPORATION	corporation
/WORK_OF_ART/PLAY	play
/WORK_OF_ART/BOOK	book
/ORGANIZATION/GOVERNMENT	government
/FACILITY/BRIDGE	bridge
/ORGANIZATION/HOSPITAL	hospital
/EVENT/WAR	war
/PLANT	plant
/ORGANIZATION/MUSEUM	museum
/ANIMAL	animal
/FACILITY/ATTRACTION	attraction
/SUBSTANCE/FOOD	food
/LOCATION/CONTINENT	continent
/GPE	geopolitical
/PERSON	person
/LAW	law
/LOCATION	location
/ORGANIZATION	organization
/LANGUAGE	language
/FACILITY/HIGHWAY_STREET	highway/street
/CONTACT_INFO/url	url
/DISEASE	disease
/EVENT/HURRICANE	hurricane
/PRODUCT/VEHICLE	vehicle
/GPE/COUNTRY	country
/SUBSTANCE	substance
/ORGANIZATION/EDUCATIONAL	educational
/GAME	game
/LOCATION/REGION	region
/ORGANIZATION/RELIGIOUS	religious
/FACILITY/AIRPORT	airport